12
Level 2
assets/Level2.png
1
95 395
695 395
0 0 0 0 0 0 0
0 0 0 0 0 0 0
0 0 0 0 0 0 0
1 1 2 0 1 1 1
0 0 1 0 1 0 0
0 0 2 1 3 0 0
0 0 0 0 0 0 0
1
3 1
