13
Level 3
assets/Level3.png
1
95 95
695 595
1 1 2 0 1 1 1
0 0 1 0 1 0 1
0 1 1 1 3 1 1
0 1 1 0 1 0 1
0 1 1 1 1 0 1
0 1 0 0 1 0 1
0 2 1 1 1 0 0
2
3 3
2 1
